--------------------------------------------------------------------------------
| |       |           |       |     |           |             |       |         |
| + +-+ +-+ + +-+-+-+ + +-+-+ + +-+ +-+ +-+-+-+ + + +-+-+-+-+-+ +-+ + + +-+-+-+ +
| | |   |   |       |   | |   | | |     |     | | | |     |     |   | | |   | | |
| + +-+-+ +-+-+-+-+ +-+-+ + +-+ + +-+-+-+ +-+-+ +-+ + +-+ + +-+-+ +-+ + + + + + +
| | |     |       | |     |     |     |   |   |   | | |   | |   | |     | | |   |
| + + +-+-+-+ +-+-+ +-+-+ +-+-+-+ +-+-+ + + + +-+ + + + +-+ +-+ + + +-+-+ + + +-+
| |   |     |     |     |       |       | | |   | |   |   |     | | |     | |   |
| +-+ +-+ + +-+-+ +-+-+ +-+ +-+ + +-+-+-+ + +-+ + +-+-+ + +-+-+ + + + +-+-+ +-+ +
|   |     |       |   |   |   | | |     | |   |   |   | |       | | | |     |   |
|-+ +-+-+ +-+-+-+-+ + + + +-+-+ + + +-+ + +-+ +-+-+ + +-+-+-+-+-+ +-+ + +-+-+-+-+
| | |     |         | | |     | | |   | |   | |     |   |       |     | |       |
| + + +-+-+ +-+-+-+-+ +-+-+-+ + + + + +-+ + + +-+-+ +-+ + +-+-+ +-+-+ + + +-+-+ +
|   |   |   |       |   |     | | | |   | | | |     | |   |   |     | |   |   | |
| +-+ +-+ +-+-+-+-+ +-+ + +-+-+ + + +-+ + +-+ + +-+-+ +-+-+ +-+-+-+ + +-+-+ + + +
|   | |   |         |   | | |     |   | |     | | |       |       | |     | |   |
|-+ +-+ +-+ +-+-+-+-+ +-+ + + +-+-+ +-+ +-+-+-+ + + +-+-+ + + +-+-+ +-+-+-+ +-+ +
| |     |   |       |     | | |     |   |       | | |   |   |       |     | | | |
| +-+-+-+ +-+ +-+-+ +-+-+-+ + +-+-+-+ + +-+-+ +-+ + + + +-+-+-+-+-+-+ +-+ + + + +
|     |       |   |       | |   |     |       |     | |         |     | |   | | |
| + +-+ +-+-+-+-+ +-+-+ + + +-+ + +-+-+-+-+-+-+ +-+-+ + +-+-+-+ + +-+ + +-+-+ + +
| |   | |         |     |   | |   |         |   |     |   |     |   | | |     | |
| +-+ + +-+-+-+ + + +-+-+-+ + +-+-+ +-+-+-+ + +-+ +-+-+-+ +-+ +-+ +-+ + + + +-+ +
| |   | |     | | | |     |       |   |   |   |   |     |   |   | |   |   | |   |
|-+ + + + +-+ + + + +-+ +-+ +-+-+-+-+ + + +-+-+-+-+ +-+ +-+ +-+ +-+ +-+ +-+ + +-+
|   | | | | |   | |   |     |       |   | |     |   | |     | |     |   |   | | |
| +-+-+ + + +-+-+ +-+ + +-+-+ +-+ +-+-+-+ + +-+ + +-+ +-+-+-+ +-+-+-+-+-+ + + + +
| |   |   | |   | |   |   |     |       |   | |   | |                     | |   |
| + + +-+-+ + + + + +-+-+-+ +-+-+ +-+ +-+-+-+ +-+-+ + +-+-+-+-+-+-+ + +-+-+-+-+ +
|   |     |   |   |   |     |   |   | |   |     |   | |   |       | | |       | |
| +-+ +-+ + +-+-+-+-+ + +-+-+ + +-+-+ + + + +-+ + + + + + + +-+-+ + +-+ +-+-+ + +
| |   |   | |       |   |   | |     |   |     | | | |   |   |   | |   |     | | |
|-+ +-+ +-+ + + +-+ +-+-+-+ + +-+-+ + +-+-+-+ + + + + +-+-+-+ + +-+-+ +-+-+ + + +
|   | | |   | |   | |     | |     | | |     | |   |   |       |         |   |   |
| +-+ + + +-+-+-+ +-+ + + + +-+-+ + + + +-+ +-+-+ +-+-+ +-+-+-+ +-+-+-+ + +-+-+-+
| |   | |       |     | |     |   | | |   |     | |   | | |     |     | | |     |
| +-+ + +-+-+-+ + +-+-+ +-+-+ + +-+ + +-+ +-+-+ +-+ + + + + +-+-+ +-+ + + + +-+-+
|   |     |   | |   |   |     | | | |   |   | |     |   |   |       | | | |     |
| + +-+-+ + + + +-+ + +-+ +-+-+ + + +-+-+-+ + +-+-+-+-+-+ +-+ +-+-+-+ + + +-+-+ +
| | |   | | |   |   | |   |   | |           |     |   |   |     |     | |     | |
| + + + +-+ +-+-+-+-+ + +-+ + + +-+-+-+-+-+-+-+-+ + + + +-+ +-+-+ +-+-+ +-+-+ + +
| | | |     |         | |   | |       |   |     |   |     | |     |         |   |
| + + +-+-+-+-+-+ +-+-+ + +-+ +-+-+-+ + + + +-+ +-+ +-+-+-+ + +-+-+ +-+-+-+ +-+ +
| | |         |   | |   |   |   |     | |   | |   |   |     | |   | |   |   | | |
| + +-+-+-+-+ + +-+ + +-+-+-+-+ + +-+ + +-+-+ +-+ +-+-+ +-+-+ + + + + + + +-+ + +
| |         |   |   |         | |   | | | |     |       |   |   | | | | |     | |
| +-+-+-+ +-+-+-+ +-+-+-+-+-+ + +-+ +-+ + + +-+ +-+-+-+-+ + +-+-+ +-+ + +-+-+-+ +
|       |         |     |     |   |     |   |   |     |   |     | |   | |   |   |
|-+-+-+-+-+ +-+-+ + +-+ + +-+-+ + +-+-+-+-+-+ + +-+ + +-+ +-+-+ + + +-+ + + + +-+
|   |   |   |   | | |   | |     |             |     |   |     | |   | |   | |   |
| + + + + +-+ + +-+ + +-+ + +-+ +-+-+-+-+-+-+-+-+-+-+-+ +-+-+-+ +-+-+ +-+-+ +-+ +
| |   | |     | |   |     | |   |                     |   |   | |     |   | |   |
| +-+-+ + +-+-+ + +-+-+-+-+ + +-+ +-+-+-+-+ + +-+-+-+-+-+ + + + + + +-+ + + + +-+
| |     |     | |     |   | |   | |   |   | | |         |   | |   | |   | | | | |
| +-+-+ +-+-+-+ +-+-+ +-+ + +-+ + +-+ + + +-+ + +-+-+-+ +-+-+ +-+-+ + +-+ + + + +
| |   |             |   |     | |     | |   | | |     |     |   |   | | | | | | |
| + + +-+-+ +-+-+-+-+-+ + +-+-+ + +-+-+ +-+ + + + +-+ +-+-+ +-+ + + + + + + + + +
|   | | |   |         | | |     | |   |   |   |   |   |   | |     | | | | | |   |
| +-+ + + +-+ +-+-+-+ + + + +-+ +-+ + +-+ + +-+-+-+ +-+ + + + +-+-+-+ + + + +-+ +
| |   |     | |     |   | |   | |   | |   | |     | |   |   |   |   | |   | |   |
| + + +-+-+-+ + +-+ +-+-+ +-+ +-+ +-+ + +-+ + +-+ + + +-+-+-+ +-+ + + + +-+ + +-+
| | | |       |   |   |   | |     | | | |   | | |   |       | |   |   | |   | | |
| + + + +-+-+-+-+ +-+ +-+ + +-+-+-+ + + +-+-+ + +-+-+-+-+-+ + + +-+-+-+ +-+ + + +
| | | |         |   |   |         | | |       |     |     | | |   |         | | |
|-+ + +-+-+-+-+ + + +-+ +-+-+-+-+ + + +-+-+ +-+ +-+-+ +-+ + + +-+ + +-+-+-+-+ + +
|   |     |   | | |   | |       | | |     |   |     |   |   |   | | |       | | |
| +-+-+-+ +-+ + +-+-+ + +-+-+-+ + + +-+-+ +-+ +-+-+ +-+ +-+-+-+ + + + +-+-+ + + +
| |       |   |       |       |   |   |   | |         |   |   | | | | | |   | | |
| + +-+-+-+ +-+-+-+-+-+-+-+-+ + +-+ +-+ +-+ +-+-+-+-+ +-+ + + + + +-+ + + +-+ + +
| |   |     |               | | |     |   |   |         |   | | |     | |     | |
| +-+ + + +-+ +-+-+-+-+-+ +-+ + +-+-+ +-+ + +-+ +-+-+-+-+-+-+ + +-+-+-+ +-+-+-+ +
| | | | |   |   |   |   |     | |   |   | |         |     |   | | |     |       |
| + + +-+-+ +-+ + + + + +-+-+-+ + + +-+ + +-+ +-+-+-+ +-+ + +-+ + + + + +-+-+-+ +
| |           |   |   |   |   |   |     |   |   |     | | |   | |   | |       | |
| +-+-+-+ +-+-+-+-+-+-+-+ + + + +-+-+-+-+ + +-+ + +-+-+ + +-+ + +-+-+ +-+-+-+ + +
| |   |   |           | |   | | |       | | |   | |   |   |   | |   |     | | | |
| + + +-+ + +-+-+ +-+ + +-+-+ + + +-+-+ +-+ +-+ + + + + +-+ +-+ + + +-+-+ + + + +
| | |   | | |   |   |   |   | | |   | |   |   | |   | |     |   | |       |   | |
| + +-+ +-+ + + +-+ +-+-+ + + +-+-+ + +-+ +-+ + +-+-+ +-+-+-+ +-+ +-+-+-+-+ +-+ +
|     |       |   |       |         |         |     |             |             |
|-+-+-+-+-+-+-+-+-+-+-+-+-+-+-+-+-+-+-+-+-+-+-+-+-+-+-+-+-+-+-+-+-+-+-+-+-+-+-+-+